{"room_0_0": [
    [0, 0, 0, 0, 0, 0, 0, 0, 0, 0, 0, 0, 0, 0, 0, 0, 0, 0, 0, 0],
    [2, 2, 2, 2, 2, 2, 2, 2, 2, 2, 2, 2, 2, 2, 2, 2, 2, 2, 2, 2],
    [3, 3, 3, 3, 3, 3, 3, 3, 3, 3, 3, 3, 3, 3, 3, 3, 3, 3, 3, 3],
    [7, 13, 0, 0, 0, 0, 0, 0, 0, 0, 0, 0, 20, 21, 9, 9, 9, 9, 9, 9],
    [7, 0, 0, 0, 0, 0, 15, 0, 0, 0, 28, 0, 20, 21, 0, 0, 0, 0, 0, 0],
    [7, 0, 0, 0, 0, 0, 0, 0, 0, 0, 0, 0, 20, 21, 0, 0, 0, 0, 0, 0],
    [7, 0, 0, 27, 0, 0, 0, 0, 12, 0, 0, 0, 20, 21, 0, 0, 12, 0, 0, 0],
    [7, 1, 1, 1, 1, 1, 1, 1, 11, 1, 1, 1, 20, 21, 1, 1, 11, 1, 1, 31],
    [7, 0, 0, 0, 0, 0, 0, 0, 10, 0, 0, 0, 20, 21, 9, 9, 24, 0, 9, 9]
],
  "room_0_1": [
    [0, 0, 0, 0, 0, 0, 0, 0, 0, 0, 0, 0, 0, 0, 0, 0, 0, 0, 0, 0],
    [2, 2, 2, 2, 2, 2, 2, 2, 2, 2, 2, 2, 2, 2, 2, 2, 2, 2, 2, 2],
    [3, 3, 3, 3, 3, 3, 3, 3, 3, 3, 3, 3, 3, 3, 3, 3, 3, 3, 3, 3],
    [9, 9, 9, 9, 9, 9, 9, 9, 9, 9, 9, 9, 9, 9, 9, 9, 9, 9, 9, 9],
    [0, 0, 0, 13, 0, 0, 0, 0, 0, 0, 0, 0, 0, 0, 0, 0, 13, 0, 0, 0],
    [0, 0, 0, 0, 0, 18, 16, 0, 0, 17, 0, 0, 0, 0, 0, 0, 0, 0, 0, 0],
    [0, 0, 0, 0, 0, 0, 0, 0, 0, 0, 0, 0, 0, 0, 0, 0, 12, 0, 0, 0],
    [1, 1, 1, 1, 1, 1, 1, 1, 1, 1, 1, 1, 1, 1, 1, 1, 11, 1, 1, 31],
    [9, 9, 9, 9, 7, 0, 0, 0, 0, 0, 0, 0, 0, 0, 0, 0, 10, 0, 0, 7]
  ],
  "room_0_2": [
    [0, 0, 0, 0, 0, 0, 0, 0, 0, 0, 0, 0, 0, 0, 0, 0, 0, 0, 0, 0],
    [2, 2, 2, 2, 2, 2, 2, 2, 2, 2, 2, 2, 2, 2, 2, 2, 4, 0, 0, 0],
    [3, 3, 3, 3, 3, 3, 3, 3, 3, 3, 3, 3, 3, 3, 3, 3, 5, 6, 0, 0],
    [9, 9, 9, 9, 9, 9, 9, 9, 9, 9, 9, 9, 9, 9, 7, 0, 0, 0, 0, 0],
    [0, 0, 0, 13, 0, 0, 0, 0, 13, 0, 0, 0, 0, 0, 7, 0, 0, 0, 0, 0],
    [0, 0, 0, 0, 0, 0, 0, 0, 0, 0, 0, 19, 0, 0, 7, 0, 0, 0, 0, 0],
    [0, 27, 0, 0, 0, 0, 0, 0, 0, 33, 0, 0, 0, 0, 7, 0, 0, 0, 0, 0],
    [31, 1, 1, 1, 1, 1, 1, 1, 1, 1, 1, 1, 1, 1, 31, 0, 0, 0, 0, 0],
    [8, 8, 8, 8, 8, 8, 8, 8, 8, 8, 8, 8, 8, 8, 8, 0, 0, 0, 0, 0]
  ],
  "room_1_0": [
    [7, 0, 0, 0, 0, 0, 0, 0, 10, 0, 0, 0, 20, 21, 0, 0, 10, 0, 0, 0],
    [7, 13, 0, 0, 0, 0, 0, 0, 10, 0, 0, 0, 20, 21, 0, 0, 10, 0, 0, 0],
    [7, 0, 0, 0, 0, 0, 0, 0, 10, 0, 0, 0, 20, 21, 0, 0, 10, 0, 0, 0],
    [7, 12, 0, 0, 0, 0, 0, 0, 10, 0, 0, 0, 20, 21, 0, 0, 10, 0, 0, 27],
    [7, 11, 1, 1, 1, 1, 1, 1, 1, 1, 1, 1, 31, 31, 1, 1, 1, 1, 1, 31],
    [7, 10, 0, 0, 0, 0, 0, 0, 0, 0, 0, 0, 22, 23, 0, 0, 0, 0, 0, 0],
    [7, 10, 0, 29, 0, 0, 0, 0, 0, 0, 18, 0, 26, 0, 0, 17, 0, 0, 0, 0],
    [7, 10, 0, 0, 0, 0, 0, 0, 0, 0, 0, 0, 0, 0, 0, 0, 0, 0, 0, 0],
    [7, 1, 1, 1, 1, 1, 1, 1, 1, 1, 1, 1, 1, 1, 1, 1, 1, 1, 1, 31]
    ],
  "room_1_1": [
    [0, 0, 0, 0, 7, 0, 0, 0, 0, 0, 0, 0, 0, 0, 0, 0, 10, 0, 0, 7],
    [0, 0, 0, 0, 7, 13, 0, 0, 0, 0, 0, 0, 14, 0, 0, 0, 10, 0, 0, 7],
    [0, 0, 0, 0, 7, 0, 0, 0, 0, 0, 0, 0, 0, 0, 0, 29, 10, 0, 0, 7],
    [0, 0, 12, 0, 7, 0, 0, 12, 0, 0, 0, 0, 0, 0, 0, 0, 10, 0, 0, 7],
    [1, 1, 11, 1, 31, 1, 1, 11, 1, 1, 1, 1, 1, 1, 1, 1, 1, 1, 1, 31],
    [0, 0, 10, 0, 13, 7, 0, 10, 0, 0, 13, 0, 0, 0, 13, 0, 0, 0, 0, 0],
    [0, 0, 10, 0, 0, 7, 0, 10, 0, 0, 0, 0, 0, 0, 0, 0, 0, 0, 0, 0],
    [0, 0, 10, 0, 0, 7, 0, 10, 0, 0, 0, 0, 0, 0, 0, 0, 0, 0, 0, 0],
    [1, 1, 1, 1, 1, 31, 1, 1, 1, 1, 1, 1, 1, 1, 1, 1, 1, 1, 1, 31]
  ],
  "room_1_2": [
    [0, 0, 0, 0, 0, 0, 0, 0, 0, 0, 0, 0, 0, 0, 0, 0, 0, 0, 0, 0],
    [0, 0, 0, 0, 0, 0, 0, 0, 0, 0, 0, 0, 0, 0, 0, 0, 0, 0, 0, 0],
    [0, 0, 0, 0, 0, 0, 0, 0, 0, 0, 0, 0, 0, 0, 0, 0, 0, 0, 0, 0],
    [0, 0, 0, 0, 0, 0, 0, 0, 0, 0, 0, 0, 0, 0, 0, 0, 0, 0, 0, 0],
    [0, 0, 0, 0, 0, 0, 0, 0, 0, 0, 0, 0, 0, 0, 0, 0, 0, 0, 0, 7],
    [0, 0, 0, 0, 0, 0, 0, 0, 30, 0, 0, 0, 0, 32, 0, 0, 32, 0, 0, 7],
    [0, 0, 0, 0, 0, 0, 0, 0, 0, 0, 0, 0, 0, 0, 0, 0, 0, 0, 0, 7],
    [0, 0, 0, 0, 0, 0, 0, 0, 0, 0, 0, 0, 0, 0, 0, 0, 0, 0, 0, 7],
    [25, 25, 25, 25, 25, 25, 25, 25, 25, 25, 25, 25, 25, 25, 25, 25, 25, 25, 25, 25]
  ]
}